111101111111011
100101000001010
301101110111010
010101010100010
110111010111110
010000111000010
010000000000011
111111111110101
100000010011101
100111011100001
100101000111101
111101110100101
000000010100011
001111010111010
002001110001110
